10
OOOOOOOOOO
OOTOOOOOOO
OTTTTTOOOO
TTTTTTTTTO
TTTTTTTTTT
