010
OOOOOOOOOO
OOOOOOOOOO
OOOOOOOOOO
OOTOOOOOOO
OTTTTTOOOO
TTTTTTTTTO
TTTTTTTTTT
