010
OOOOOOOOOO
OOOOOOOOOO
OOOOOOOOOO
OOEOOOOOOO
OOOOOOOOOO
OOOOOOOOOO
OOOOOOOOOO
OOOOOOOOOO
OOOOOOOOOO
OOOOOOOOOO
OOOOOOOOOO
OOOOOOPTOO
TOTTOOTTTT
TTTTTTTTTT
TTTTTTTTTT
1
