10
OOOOOOOOOO
OOOOOOOOOO
OOOOTTOOOT
OOOTTOOOTT
TTTTTTTTTT
