010
OOOOOOOOOO
OOOOOOOOOO
OOOOOOOOOO
OOOOOOOOOO
OOOOOOOOOO
OOOOOOOOOO
OOOOOOOOOO
OOOOOOOOOO
OOOOOOOOOO
OOOODDOOOO
OODDOOOOOO
ODOOOOOOOO
DOOOOOOOOO
OOOOOOOOOD
BBBDDODOOD
2
