010
OOOCOOCOOO
OCOCOOCOCO
OCOOOOOOCO
OOCOOOOCOO
OOOOOOOOOO
OOOOOOOOOO
OOOOOOOOOO
OOOOOOOOOO
OOOOOOOOOO
OOCCCCOOOO
OOCOOOOOOO
OCOOOOOOOO
COOOCOOOOO
OOOOOCOOOO
OOOOOOCCCC
0
