010
OOOOOOOOOO
OOOOOOOOOO
OOOOOOOOOO
OOOOOOOOOO
OOOOOOOOOO
OOOOOOOOOO
OOOOOOOOOO
OOOOOOOOOO
OOOOOOOOOO
OOOEOOOOOO
OOOOOOOOOO
OOOOOOOOOO
OOOOOOOOOO
TOOOOOPOOO
TTTTTTTTTT
0
