012
OOOOOOOOOOOO
OOOOOOOOOOOO
OOOOOOOOOOOO
OOOOOOOOOOOO
OOOOOOOOOOOO
OOOOOOOOOOOO
OOOOOOOOOOOO
OOOOOOOOOOOO
OOOOOOOOOOOO
OOOOOOOOOOOO
OOOOOBBOOOOO
OOBBBBOOOOOO
OBOOOOOOOOOO
BOOOOOOOOOOO
OBBBOOOOBBBP
0
