010
OOOOOOOOOO
OOOOOOOTOO
TOTTOOTTTT
TTTTTTTTTT
TTTTTTTTTT
