010
OOOOOOOOOO
OOOOOOOOOO
OOOOOOOOOO
OOOOOOOOOO
OOOOOOOOOO
OOOOOOOOOO
OOOOOOOOOO
OOOOOOOOOO
OOGOOGOOOO
OGOOOOGOOO
OOOGOOOGOO
OOGOOOOOGO
OOGOOOOOOG
GGOOOOOOOG
GOOOOOOOOG
1
