017
OOTOOOOOOOOOOOOOO
OOOTOOOOOOOOOOOOO
OOOOOOOOOOOOOOOOO
OOOOOOOOOOOTOOOOO
OOOOOOOOOOTOOOOOO
OOOOOOOOOTOOOOOOO
TTTTTTTSTTTTTTTTT
0
