010
OOOOOOOOOO
OOOOOOOOOO
OOOOOOOOOO
OOOOOOOOOO
OOOOTTOOOT
OOOTTOOOTT
TTTTTTTTTT
1
