010
OOOOOOOOOO
OOOOOOOOOO
OOOOOOOOOO
OOOOOOOOOO
OOOOOOOOOO
OOOOOOOOOO
OOOOOOOOOO
OOOOEOOOOO
OOOOOOOOOO
OOOOOOOOOO
OOOOTTOOOO
OOOOOOOOOO
OOOOOOOOOT
OOOOOOOOTT
TTTTTOOTTT
1
