010
OOOOOOOOOO
OOOOOOOOOO
OOOOOOOOOO
OOOOOOOQOO
OOOOOOQOOO
OOOOOQOOOO
OOOOOOOOOO
OQOOOOOOOO
OOQOOOOOOO
OOOOOOOOOO
OOOOOQOOOO
OOOOQOOOQO
OOOQOOOOOQ
OOQOOOOOOO
QQOOOOOOOO
1
