200
OOOOOOOOOOOOOOOOOOOOOOOOOOOOOOOOOOOOOOOOOOOOOOOOOOOOOOOOOOOOOOOOOOOOOOOOOOOOOOOOOOOOOOOOOOOOOOOOEOOOOOOOOOOOOOOOOOOOOOOOOOOOOOOOEOOOOOOOOOOOEOOOOOOOOOOOOOEOOOOOOOOOOOOEOOOOOOOOOOEOOOOOOOOOEOOOOOEOOOOO
OOOOOOOOOOOOOOOOOOOOOOOOOOOOOOOOOOOOOOOOOOOOOOOOOOOOOOOOOOOOOOOOOOEOOOOOOOOOOOOEOOOOOOOOOOOOOOOOOOOOOOOOOOOOOOOOOOEOOOOOOOOOOOOOOOOOOOOOOOOOOOOOOOOOOOOOOOOOOOOOOOOOOOOOOOOOOOOOOOOOOOOOOOOOOOOOOOOOOOOO
OOOOOOOOOOOOEOOOOEOOOOEOOOOOOOOOOOOEOOOOOOOOOOOOOEOOOOOOOOOOOOOOOOOOOOOOOOOOOOOOOOOOOOOOOOOOOOOOOOOOOOOOOOOOOOOOOOOOOOOOOOOOOOOOOOOOOOOOOOOOOOOOOOOOOOOOOOOOOOOOOOOOOOOOOOOOOOOOOOOOOOOOOOOOOOOOOOOOOOOO
OOOOOOOOOOOOOOOOOOOOOOOOOOOOOOOOOOOOOOOOOOOOOOOOOOOOOOOOOOOOOOOOOOOOOOOOOOOOOOOOOOOOOOOOOOOOOOOOOOOOOOOOOOOOOOOOOOOOOOOOOOOOOOOOOOOOOOOOOOOOOOOOOOOOOOOOOOOOOOOOOOOOOOOOOOOOOOOOOOOOOOOOOOOOOOOOOOOOOOOO
OOOOOOOOOOOOOOOOOOOOOOOOOOOOOOOOOOOOOOOOOOOOOOOOOOOOOOOOOOOOOOOOOOOOOOOOOOOOOOOOOOOOOOOOOOOOOOOOOOOOOOOOOOOOOOOOOOOOOOOOOOOOOOOOOOOOOOOOOOOOOOOOOOOOOOOOOOOOOOOOOOOOOOOOOOOOOOOOOOOOOOOOOOOOOOOOOOOOOOOO
OOOOOOOOOOOOOOOOOOOOOOOOOOOOOOOOOOOOOOOOOOOOOOOOOOOOOOOOOOOOOOOOOOOOOOOOOOOOOOOOOOOOOOOOOOOOOOOOOOOOOOOOOOOOOOOOOOOOOOOOOOOOOOOOOOOOOOOOOOOOOOOOOOOOOOOOOOOOOOOOOOOOOOOOOOOOOOOOOOOOOOOOOOOOOOOOOOOOOOOO
OOOOOOOOOOOOOOOOOOOOOOOOOOOOOOOOOOOOOOOOOOOOOOOOOOOOOOOOOOOOOOOOOOOOOOOOOOOOOOOOOOOOOOOOOOOOOOOOOOOOOOOOOOOOOOOOOOOOOOOOOOOOOOOOOOOOQOQQOOOOOQOOOOOOOOOOOOOOOOOOOOOOOOOOOOOOOOOOOOOOOOOOOOOOOOOOOOOOOOOO
OOOOOOOOOOOOOOOOBBBBOOOOOOOOOOOOOOOOOOOOOOOOOOOOOOOOOOOHHHHHHOOOOOOOOOOOOOOOOOOOOOOOOOOOOOOOOOOOOOOOOOOOOOOOOOOOOOOOOOOOOOOOOOOOOOOQOOOOQOOOOOOOOOOOOOOOOOOOOOOOOOOOOOOOOOOOOOOOOOOOOFFFFOOOOOOOOOOOOOOO
OOOOOOOOOOOOOOOOOOOOOOOOOOOOOOOOOOOOOOOOOOOOOOOOOOOOOOOOOOOOOOOOOOOOOOOOOOOOOOOOOOOOOOHHHHHHOOOOOOOOOOOOOOOOOOOOOOOOOOOOOOOOOOOOOOQOOOOOOQOOOOOOOOOOOOOOOOOOOOOOOOOOOOOOOOOOOOOOOOOOFOOOOFOOOOOOOOOOOOOO
OOOOOOOOOOOOOOOOOOOOOOOOOOOOOOOOOOOOOOOOOOOOOOOOOOOOOOOOOOOOOOOOOOOOOOOOOOOOOOOOOOOOOOOOOOOHOOOOOOOOOOOOOOOOOOOOOOOOOOOOOOOOOOOOOQOOOOOOOOQQOOOOQQQOOOOOOOOOOOOOOOOOOOOOOOOOOOOOOOOFOOOOOOOOOOOOOOOOOOOO
OOOOOOOOOOOOBOOBOBOOOOBOOOOOOOOOOOOOOOOOOOOOOOOOOHHHHHOOOOOOOHHHHHHHHHOOOOOOOOOOOOOOOOOOOOOOHHOOOOOOOOOOOOOOOOOOOOOOOOOOOOOOOOOOQOOOOOOOOOOOOOOOOOOQOOOOOOOOOOOOOOOOOOOOOOOOOOOOOOFOOOOOOOOOOOOOOOOOOOOO
OOOOBOOOBOOOOOOOOOOOOOOBOOOOOOOOOOOOOOOOOOOOOOOOOOOOOOOOOOOOOOOOOOOOOHHOOOOOOOOOOOOOOOOOOOOOOOHOOOOOOOOOOOOOQQQQOOOOOOOOOOOOOOOQOOOOOOOOOOOOOOOOOOOOQQQQQOOOOOOOOOOOOOOOOOOOOOOOOFOOOOOOOOOOOOOOOOOOOOOO
OOOBBOOOBBOOOOOOOOOOOOOBOOOOOOOOOOOOOOOOOOOOOOOOHOOOOOOOOOOOOOOOOOOOOHHHOOOOOHHHHHHHHOOOOOOOOOHOOOOOOOOOOOOOOOOOOOOOOOOOOOOOOOQOOOOOOOOOOOOOOOOOOOOOOQOOOQOOOOOOOOOOOOOOOFOOOOOOFOOOOOOOOOOOOOOOOOOOOOOO
OOBBBOOOBBBOOOOOOOOOOOOBOOOPOOOOOOOOOOOOOOOOOOOOOOOOOOHHHHHOOOOOOOOOOHHHHOOOOOOOOOOOOOOOOOOOOOHOOOPOOOOOOOOOOOOOOOOOOOOOOOOOOQOOOOOOOOOOOOOOOOOOOOOOOOOOOOQOOOOOOOOOOPOOOOOOOOFFOOOOOOOOOOOOOOOOOOOOOOOO
SBBBBOOOBBBBBBBOOOOOOOOBBBBHHHHHHHHHHHHHHHHHHHHHOOOOOOOOOOHOOOOOOOOOOHHHHHHHOOOOOOHHHHHHHOOOOOHHHHQQQQQQQQQQOOOOOQQQQQQQQQQQQOOOOOOOOOOOOOOOOOOOOOOOOOOOOOQQQQQQQQQQQFFOOOOOFFOOOOOFFFFFFFFFFFFFOOOOAAAA
0